5 10
|--------|
|E..|..-.|
|..-|.@P.|
|.E....-E|
|--------|